Word	Category
compassion	care_virtue
empathy	care_virtue
kindness	care_virtue
caring	care_virtue
generosity	care_virtue
benevolence	care_virtue
altruism	care_virtue
compassionate	care_virtue
nurture	care_virtue
gentleness	care_virtue
nurturance	care_virtue
sympathy	care_virtue
nurturing	care_virtue
motherly	care_virtue
love	care_virtue
beneficence	care_virtue
empathize	care_virtue
helpfulness	care_virtue
loving	care_virtue
pity	care_virtue
mercy	care_virtue
nurturer	care_virtue
compassionately	care_virtue
nurturers	care_virtue
caringly	care_virtue
empathising	care_virtue
merciful	care_virtue
empathizing	care_virtue
nurtures	care_virtue
warmhearted	care_virtue
empathizers	care_virtue
protectiveness	care_virtue
nurtured	care_virtue
benevolent	care_virtue
mothering	care_virtue
cared	care_virtue
healing	care_virtue
empathises	care_virtue
humane	care_virtue
comfort	care_virtue
pitied	care_virtue
loved	care_virtue
altruist	care_virtue
cares	care_virtue
pitying	care_virtue
comforted	care_virtue
hug	care_virtue
comforting	care_virtue
consoling	care_virtue
empathizes	care_virtue
sympathize	care_virtue
care	care_virtue
caregiver	care_virtue
empathised	care_virtue
hugs	care_virtue
heal	care_virtue
generous	care_virtue
condolences	care_virtue
mothered	care_virtue
charitable	care_virtue
generously	care_virtue
pities	care_virtue
condolence	care_virtue
help	care_virtue
consolingly	care_virtue
solace	care_virtue
mother	care_virtue
healer	care_virtue
hospitality	care_virtue
charity	care_virtue
empathized	care_virtue
healers	care_virtue
pityingly	care_virtue
mothers	care_virtue
child	care_virtue
lovingly	care_virtue
parenting	care_virtue
rescuing	care_virtue
rescuer	care_virtue
loves	care_virtue
consoled	care_virtue
clothe	care_virtue
sympathizing	care_virtue
helping	care_virtue
shared	care_virtue
childhood	care_virtue
mommy	care_virtue
vulnerability	care_virtue
helpers	care_virtue
lover	care_virtue
hospitable	care_virtue
sharer	care_virtue
feeding	care_virtue
nursed	care_virtue
helper	care_virtue
safeness	care_virtue
nurses	care_virtue
protector	care_virtue
motherhood	care_virtue
alleviation	care_virtue
nursemaid	care_virtue
safeguard	care_virtue
protect	care_virtue
healthiness	care_virtue
protecters	care_virtue
patient	care_virtue
nurse	care_virtue
vulnerable	care_virtue
benefit	care_virtue
feed	care_virtue
childcare	care_virtue
rescuers	care_virtue
hugged	care_virtue
helpful	care_virtue
rescues	care_virtue
nursing	care_virtue
protecting	care_virtue
heals	care_virtue
childbearing	care_virtue
hugger	care_virtue
relief	care_virtue
healed	care_virtue
rescued	care_virtue
patients	care_virtue
share	care_virtue
rescue	care_virtue
healthy	care_virtue
hospitalise	care_virtue
hospitalising	care_virtue
hugging	care_virtue
nursery	care_virtue
healthier	care_virtue
sharing	care_virtue
helps	care_virtue
sympathizers	care_virtue
hospitalises	care_virtue
alleviating	care_virtue
wounded	care_virtue
wounds	care_virtue
hospitalize	care_virtue
alleviate	care_virtue
protective	care_virtue
protection	care_virtue
health	care_virtue
relieve	care_virtue
sympathizer	care_virtue
safety	care_virtue
beneficiary	care_virtue
helped	care_virtue
hospital	care_virtue
childbirth	care_virtue
benefits	care_virtue
healthcare	care_virtue
relievers	care_virtue
feeds	care_virtue
hospitalization	care_virtue
benefitting	care_virtue
relieving	care_virtue
safe	care_virtue
feeder	care_virtue
benefitted	care_virtue
hospitalized	care_virtue
unharmful	care_virtue
protects	care_virtue
unharmed	care_virtue
protecter	care_virtue
safely	care_virtue
safekeeping	care_virtue
hospitalizing	care_virtue
wounding	care_virtue
reliever	care_virtue
shares	care_virtue
relieves	care_virtue
alleviates	care_virtue
relieved	care_virtue
hospitalizes	care_virtue
console	care_virtue
protectorate	care_virtue
alleviated	care_virtue
protected	care_virtue
wound	care_virtue
consoles	care_virtue
harm	care_vice
suffer	care_vice
hurt	care_vice
harmed	care_vice
hurting	care_vice
hurts	care_vice
cruel	care_vice
endanger	care_vice
harming	care_vice
harms	care_vice
suffering	care_vice
threaten	care_vice
inflict	care_vice
suffered	care_vice
harmful	care_vice
inflicted	care_vice
mistreat	care_vice
endangers	care_vice
damaging	care_vice
injurious	care_vice
victimize	care_vice
inflicts	care_vice
hurtful	care_vice
suffers	care_vice
inflicting	care_vice
injures	care_vice
vulnerable	care_vice
unkind	care_vice
damage	care_vice
kill	care_vice
die	care_vice
victimizes	care_vice
torment	care_vice
destroy	care_vice
brutalise	care_vice
brutalises	care_vice
distresses	care_vice
endangering	care_vice
mistreats	care_vice
afflict	care_vice
distressing	care_vice
destroys	care_vice
victimises	care_vice
maltreat	care_vice
pain	care_vice
harsh	care_vice
mistreated	care_vice
ravage	care_vice
threatened	care_vice
harass	care_vice
unkindness	care_vice
afflicted	care_vice
threatens	care_vice
threatening	care_vice
distress	care_vice
brutalize	care_vice
tormenting	care_vice
brutalized	care_vice
victimizing	care_vice
damager	care_vice
damaged	care_vice
bully	care_vice
agony	care_vice
abused	care_vice
coldhearted	care_vice
inhuman	care_vice
injured	care_vice
torments	care_vice
brutalizes	care_vice
uncompassionate	care_vice
cruelty	care_vice
tormented	care_vice
mistreating	care_vice
endangered	care_vice
uncaring	care_vice
anguishes	care_vice
destroying	care_vice
killed	care_vice
mistreatment	care_vice
bullied	care_vice
harsher	care_vice
cruelness	care_vice
tortured	care_vice
pained	care_vice
tortures	care_vice
torturing	care_vice
maltreated	care_vice
anguish	care_vice
persecutes	care_vice
maltreatment	care_vice
brutalizing	care_vice
attacked	care_vice
victim	care_vice
crying	care_vice
damages	care_vice
discomforting	care_vice
abusing	care_vice
threat	care_vice
persecute	care_vice
brutalization	care_vice
violent	care_vice
annihilated	care_vice
torturous	care_vice
harasses	care_vice
injurer	care_vice
destroyed	care_vice
molests	care_vice
molest	care_vice
injuring	care_vice
afflicts	care_vice
killing	care_vice
ache	care_vice
wounded	care_vice
persecuted	care_vice
ravages	care_vice
harassed	care_vice
exploited	care_vice
injury	care_vice
brutalisation	care_vice
discomfort	care_vice
unmerciful	care_vice
annihilate	care_vice
exploiters	care_vice
injurers	care_vice
destruction	care_vice
manhandle	care_vice
kills	care_vice
casualties	care_vice
maltreating	care_vice
victims	care_vice
harassing	care_vice
needier	care_vice
smother	care_vice
harassment	care_vice
smothers	care_vice
unhelpful	care_vice
agonize	care_vice
inhumanity	care_vice
duress	care_vice
victimization	care_vice
exploiting	care_vice
cried	care_vice
wounds	care_vice
wounding	care_vice
murderous	care_vice
ravaged	care_vice
uncaringly	care_vice
pains	care_vice
painfulness	care_vice
manhandles	care_vice
bullies	care_vice
assaulted	care_vice
uncharitable	care_vice
distressed	care_vice
persecution	care_vice
murdered	care_vice
ravaging	care_vice
discomforted	care_vice
exploitation	care_vice
torture	care_vice
murderers	care_vice
aches	care_vice
afflictions	care_vice
ungenerous	care_vice
victimizer	care_vice
agonizing	care_vice
paining	care_vice
persecuting	care_vice
exploit	care_vice
harassers	care_vice
malevolent	care_vice
stabs	care_vice
sorrowful	care_vice
assaults	care_vice
needy	care_vice
affliction	care_vice
cries	care_vice
fighting	care_vice
fight	care_vice
attack	care_vice
annihilates	care_vice
sorrow	care_vice
agonized	care_vice
assaulting	care_vice
inhospitable	care_vice
threats	care_vice
ached	care_vice
rapists	care_vice
abuser	care_vice
raped	care_vice
assassinates	care_vice
stabbed	care_vice
inhospitality	care_vice
annihilation	care_vice
punch	care_vice
harshness	care_vice
abusers	care_vice
killer	care_vice
sufferers	care_vice
victimizers	care_vice
smite	care_vice
killers	care_vice
discomforts	care_vice
fatalities	care_vice
molested	care_vice
brutality	care_vice
murdering	care_vice
torturer	care_vice
torturers	care_vice
fights	care_vice
harmfulness	care_vice
bullying	care_vice
casualty	care_vice
sufferer	care_vice
exploiter	care_vice
fatality	care_vice
punches	care_vice
abuses	care_vice
attacks	care_vice
vulnerability	care_vice
carnage	care_vice
tribulation	care_vice
annihilator	care_vice
smothering	care_vice
bullyboy	care_vice
murderer	care_vice
wound	care_vice
stabber	care_vice
tormenters	care_vice
malevolence	care_vice
raping	care_vice
smothered	care_vice
assault	care_vice
genocidal	care_vice
anguishing	care_vice
aching	care_vice
anguished	care_vice
stabbing	care_vice
rapist	care_vice
harasser	care_vice
hungers	care_vice
hunger	care_vice
molesting	care_vice
rape	care_vice
molesters	care_vice
punched	care_vice
violence	care_vice
distressingly	care_vice
molester	care_vice
stabbers	care_vice
neediness	care_vice
assassinate	care_vice
agonizingly	care_vice
tribulations	care_vice
unhelpfulness	care_vice
assaulter	care_vice
puncher	care_vice
punching	care_vice
rapes	care_vice
genocides	care_vice
attackers	care_vice
tormentor	care_vice
assassinations	care_vice
destroyers	care_vice
punchers	care_vice
sorrows	care_vice
tormenter	care_vice
threateningly	care_vice
murder	care_vice
destroyer	care_vice
assassinating	care_vice
crier	care_vice
assassinated	care_vice
molestation	care_vice
attacker	care_vice
murders	care_vice
genocide	care_vice
fighter	care_vice
assassins	care_vice
assaulters	care_vice
hungering	care_vice
achingly	care_vice
hungered	care_vice
murderess	care_vice
assassin	care_vice
exploits	care_vice
fighters	care_vice
assassination	care_vice
equality	fairness_virtue
fairness	fairness_virtue
justice	fairness_virtue
rights	fairness_virtue
equitable	fairness_virtue
civil rights	fairness_virtue
fairplay	fairness_virtue
impartiality	fairness_virtue
equal	fairness_virtue
fairminded	fairness_virtue
proportionality	fairness_virtue
equalities	fairness_virtue
fair	fairness_virtue
integrity	fairness_virtue
impartial	fairness_virtue
reciprocity	fairness_virtue
honesty	fairness_virtue
egalitarian	fairness_virtue
civil right	fairness_virtue
law	fairness_virtue
justness	fairness_virtue
unbias	fairness_virtue
egalitarians	fairness_virtue
parity	fairness_virtue
objectiveness	fairness_virtue
reparations	fairness_virtue
unprejudiced	fairness_virtue
justices	fairness_virtue
laws	fairness_virtue
tribunals	fairness_virtue
retribution	fairness_virtue
reparation	fairness_virtue
lawfully	fairness_virtue
lawful	fairness_virtue
honest	fairness_virtue
compensation	fairness_virtue
lawyers	fairness_virtue
sportsmanship	fairness_virtue
tribunal	fairness_virtue
do unto others	fairness_virtue
golden rule	fairness_virtue
lawyer	fairness_virtue
proportional	fairness_virtue
equity	fairness_virtue
lawyering	fairness_virtue
trust	fairness_virtue
reciprocal	fairness_virtue
being objective	fairness_virtue
justification	fairness_virtue
trustworthiness	fairness_virtue
unbiased	fairness_virtue
vengeance	fairness_virtue
revenge	fairness_virtue
retributions	fairness_virtue
equals	fairness_virtue
equalize	fairness_virtue
refereeing	fairness_virtue
restitution	fairness_virtue
compensating	fairness_virtue
been objective	fairness_virtue
pay back	fairness_virtue
justified	fairness_virtue
justifies	fairness_virtue
retaliation	fairness_virtue
lawyered	fairness_virtue
compensated	fairness_virtue
referees	fairness_virtue
karma	fairness_virtue
will share	fairness_virtue
avenger	fairness_virtue
trusting	fairness_virtue
avengers	fairness_virtue
square deal	fairness_virtue
trusts	fairness_virtue
compensate	fairness_virtue
trustworthy	fairness_virtue
levels the playing field	fairness_virtue
tit for tat	fairness_virtue
retaliate	fairness_virtue
level the playing field	fairness_virtue
eye for an eye	fairness_virtue
square deals	fairness_virtue
repayment	fairness_virtue
payback	fairness_virtue
equities	fairness_virtue
justify	fairness_virtue
dues	fairness_virtue
square dealing	fairness_virtue
referee	fairness_virtue
repaid	fairness_virtue
square dealer	fairness_virtue
equalizer	fairness_virtue
due processes	fairness_virtue
level playing fields	fairness_virtue
repay	fairness_virtue
compensates	fairness_virtue
justifying	fairness_virtue
due processing	fairness_virtue
due process	fairness_virtue
repayments	fairness_virtue
repaying	fairness_virtue
level playing field	fairness_virtue
retaliating	fairness_virtue
square dealers	fairness_virtue
retaliated	fairness_virtue
refereed	fairness_virtue
revenger	fairness_virtue
avenging	fairness_virtue
repays	fairness_virtue
trusted	fairness_virtue
avenge	fairness_virtue
retaliates	fairness_virtue
equalizers	fairness_virtue
avenged	fairness_virtue
avenges	fairness_virtue
cheat	fairness_vice
unfair	fairness_vice
cheating	fairness_vice
unfairness	fairness_vice
injustice	fairness_vice
fraud	fairness_vice
dishonest	fairness_vice
unjust	fairness_vice
cheated	fairness_vice
fraudulent	fairness_vice
cheats	fairness_vice
frauds	fairness_vice
dishonesty	fairness_vice
cheaters	fairness_vice
deception	fairness_vice
injustices	fairness_vice
swindle	fairness_vice
inequity	fairness_vice
hypocrisy	fairness_vice
discrimination	fairness_vice
unequal	fairness_vice
cheater	fairness_vice
inequities	fairness_vice
defraud	fairness_vice
racism	fairness_vice
scam	fairness_vice
liar	fairness_vice
defrauds	fairness_vice
betrayal	fairness_vice
deceit	fairness_vice
defrauded	fairness_vice
inequality	fairness_vice
liars	fairness_vice
defrauders	fairness_vice
hypocrite	fairness_vice
biased	fairness_vice
ripoffs	fairness_vice
scams	fairness_vice
fleecing	fairness_vice
defrauder	fairness_vice
discriminates	fairness_vice
mislead	fairness_vice
inequalities	fairness_vice
prejudice	fairness_vice
fleeced	fairness_vice
defrauding	fairness_vice
ripoff	fairness_vice
scamming	fairness_vice
imposters	fairness_vice
exploitation	fairness_vice
crooked	fairness_vice
oppress	fairness_vice
racist	fairness_vice
oppression	fairness_vice
imposter	fairness_vice
swindled	fairness_vice
hypocrites	fairness_vice
plagiarism	fairness_vice
lied	fairness_vice
untrustworthiness	fairness_vice
hoodwink	fairness_vice
scammed	fairness_vice
blackmail	fairness_vice
bilks	fairness_vice
swindling	fairness_vice
betrayed	fairness_vice
bias	fairness_vice
connive	fairness_vice
crooks	fairness_vice
deceive	fairness_vice
freeloaders	fairness_vice
favoritism	fairness_vice
disparity	fairness_vice
swindles	fairness_vice
deceived	fairness_vice
exploiters	fairness_vice
misleading	fairness_vice
discriminated	fairness_vice
bilked	fairness_vice
deceiving	fairness_vice
untrustworthy	fairness_vice
prejudiced	fairness_vice
false advertise	fairness_vice
scammers	fairness_vice
swindler	fairness_vice
theft	fairness_vice
duplicitous	fairness_vice
hoodwinked	fairness_vice
bigoted	fairness_vice
sexism	fairness_vice
disproportionate	fairness_vice
swindlers	fairness_vice
discriminate	fairness_vice
conniving	fairness_vice
sexist	fairness_vice
betraying	fairness_vice
hoodwinking	fairness_vice
partiality	fairness_vice
misleads	fairness_vice
disproportion	fairness_vice
economic disparity	fairness_vice
exploiter	fairness_vice
bilk	fairness_vice
biases	fairness_vice
bigots	fairness_vice
distrust	fairness_vice
dupe	fairness_vice
crook	fairness_vice
racists	fairness_vice
con artist	fairness_vice
bilking	fairness_vice
blackmailing	fairness_vice
deceives	fairness_vice
betrayers	fairness_vice
deceiver	fairness_vice
blackmailed	fairness_vice
duping	fairness_vice
shyster	fairness_vice
connivers	fairness_vice
imbalanced	fairness_vice
con artists	fairness_vice
sexists	fairness_vice
thieving	fairness_vice
betray	fairness_vice
imbalance	fairness_vice
disproportions	fairness_vice
disproportionately	fairness_vice
freeloader	fairness_vice
misleaders	fairness_vice
connived	fairness_vice
shysters	fairness_vice
scammer	fairness_vice
connives	fairness_vice
conniver	fairness_vice
disadvantaged	fairness_vice
plagiaristic	fairness_vice
moocher	fairness_vice
dupes	fairness_vice
discriminating	fairness_vice
tricked	fairness_vice
segregation	fairness_vice
false advertised	fairness_vice
thief	fairness_vice
betrayer	fairness_vice
bigot	fairness_vice
exploiting	fairness_vice
lying	fairness_vice
thieves	fairness_vice
stealing	fairness_vice
suckered	fairness_vice
deceivers	fairness_vice
bamboozled	fairness_vice
false advertisement	fairness_vice
freeload	fairness_vice
bamboozle	fairness_vice
did rob	fairness_vice
freeloading	fairness_vice
steal	fairness_vice
pickpocketing	fairness_vice
blackmailer	fairness_vice
prejudicing	fairness_vice
chauvinists	fairness_vice
exploit	fairness_vice
misleader	fairness_vice
hoodwinks	fairness_vice
false advertiser	fairness_vice
imbalances	fairness_vice
pickpocketed	fairness_vice
exploited	fairness_vice
pickpockets	fairness_vice
bamboozles	fairness_vice
tricking	fairness_vice
taking advantage	fairness_vice
pickpocket	fairness_vice
false advertisers	fairness_vice
biasing	fairness_vice
false impression	fairness_vice
bamboozling	fairness_vice
false witness	fairness_vice
robs	fairness_vice
moochers	fairness_vice
betrays	fairness_vice
robbing	fairness_vice
false advertises	fairness_vice
false impressions	fairness_vice
blackmails	fairness_vice
double cross	fairness_vice
blackmailers	fairness_vice
will rob	fairness_vice
stolen	fairness_vice
distrustful	fairness_vice
false advertising	fairness_vice
double crossers	fairness_vice
mooches	fairness_vice
disproportioned	fairness_vice
mooching	fairness_vice
segregated	fairness_vice
double crosser	fairness_vice
robbed	fairness_vice
misleadingly	fairness_vice
segregating	fairness_vice
stole	fairness_vice
double crosses	fairness_vice
being partial	fairness_vice
exploits	fairness_vice
distrusts	fairness_vice
mooch	fairness_vice
segregate	fairness_vice
robbers	fairness_vice
distrusted	fairness_vice
double crossing	fairness_vice
distrusting	fairness_vice
double crossed	fairness_vice
be partial	fairness_vice
go back on	fairness_vice
stacking the deck	fairness_vice
robber	fairness_vice
segregates	fairness_vice
ripping off	fairness_vice
trickster	fairness_vice
rips off	fairness_vice
behind their backs	fairness_vice
mooched	fairness_vice
stacked the deck	fairness_vice
was partial	fairness_vice
am partial	fairness_vice
stacked deck	fairness_vice
stacks the deck	fairness_vice
behind their back	fairness_vice
been partial	fairness_vice
free rider	fairness_vice
ripped off	fairness_vice
free riders	fairness_vice
deceivingly	fairness_vice
steals	fairness_vice
unequaled	fairness_vice
team player	loyalty_virtue
player	loyalty_virtue
patriot	loyalty_virtue
loyal	loyalty_virtue
loyalty	loyalty_virtue
patriots	loyalty_virtue
follower	loyalty_virtue
fidelity	loyalty_virtue
allegiance	loyalty_virtue
ally	loyalty_virtue
comrade	loyalty_virtue
loyalties	loyalty_virtue
death do us part	loyalty_virtue
faction	loyalty_virtue
comrades	loyalty_virtue
allegiances	loyalty_virtue
sacrifice	loyalty_virtue
allies	loyalty_virtue
organization	loyalty_virtue
followers	loyalty_virtue
us against them	loyalty_virtue
sacrifices	loyalty_virtue
all for one	loyalty_virtue
camaraderie	loyalty_virtue
comradery	loyalty_virtue
one for all	loyalty_virtue
fellow	loyalty_virtue
family	loyalty_virtue
allegiant	loyalty_virtue
corps	loyalty_virtue
unity	loyalty_virtue
union jack	loyalty_virtue
uniter	loyalty_virtue
old glory	loyalty_virtue
companions	loyalty_virtue
country	loyalty_virtue
companion	loyalty_virtue
homeland	loyalty_virtue
sacrificing	loyalty_virtue
indivisible	loyalty_virtue
sacrificed	loyalty_virtue
solidarity	loyalty_virtue
troops	loyalty_virtue
nation	loyalty_virtue
cult	loyalty_virtue
kinship	loyalty_virtue
companionship	loyalty_virtue
clique	loyalty_virtue
allied	loyalty_virtue
community	loyalty_virtue
group	loyalty_virtue
factions	loyalty_virtue
familiarity	loyalty_virtue
solidarities	loyalty_virtue
enlist	loyalty_virtue
companionships	loyalty_virtue
wife	loyalty_virtue
united	loyalty_virtue
belongs	loyalty_virtue
congregation	loyalty_virtue
brothers in arms	loyalty_virtue
clan	loyalty_virtue
trooper	loyalty_virtue
sect	loyalty_virtue
enlisted	loyalty_virtue
enlistment	loyalty_virtue
tribalism	loyalty_virtue
cohorts	loyalty_virtue
war	loyalty_virtue
joining	loyalty_virtue
troop	loyalty_virtue
sacrificial	loyalty_virtue
coalition	loyalty_virtue
insider	loyalty_virtue
pledge	loyalty_virtue
cohort	loyalty_virtue
enlisting	loyalty_virtue
unite	loyalty_virtue
communion	loyalty_virtue
familiarities	loyalty_virtue
belong	loyalty_virtue
ingroup	loyalty_virtue
belonged	loyalty_virtue
company	loyalty_virtue
collective	loyalty_virtue
fellows	loyalty_virtue
cliques	loyalty_virtue
uniting	loyalty_virtue
clans	loyalty_virtue
hazing	loyalty_virtue
congregates	loyalty_virtue
herd	loyalty_virtue
sects	loyalty_virtue
uniters	loyalty_virtue
undivided	loyalty_virtue
unites	loyalty_virtue
pledgers	loyalty_virtue
coalitions	loyalty_virtue
enlists	loyalty_virtue
grouping	loyalty_virtue
insiders	loyalty_virtue
families	loyalty_virtue
troupe	loyalty_virtue
fellowship	loyalty_virtue
kin	loyalty_virtue
pledger	loyalty_virtue
horde	loyalty_virtue
nations	loyalty_virtue
tribe	loyalty_virtue
hordes	loyalty_virtue
pledges	loyalty_virtue
herder	loyalty_virtue
commune	loyalty_virtue
cults	loyalty_virtue
congregations	loyalty_virtue
organizations	loyalty_virtue
herds	loyalty_virtue
pledging	loyalty_virtue
communities	loyalty_virtue
familiar	loyalty_virtue
hazings	loyalty_virtue
belonging	loyalty_virtue
pledged	loyalty_virtue
bowed	loyalty_virtue
collectively	loyalty_virtue
together	loyalty_virtue
groups	loyalty_virtue
homelands	loyalty_virtue
collectives	loyalty_virtue
troopers	loyalty_virtue
tribes	loyalty_virtue
companies	loyalty_virtue
countries	loyalty_virtue
troupes	loyalty_virtue
fellowships	loyalty_virtue
tribal	loyalty_virtue
communes	loyalty_virtue
herders	loyalty_virtue
grouped	loyalty_virtue
herding	loyalty_virtue
congregate	loyalty_virtue
herded	loyalty_virtue
congregating	loyalty_virtue
traitor	loyalty_vice
disloyal	loyalty_vice
treason	loyalty_vice
traitors	loyalty_vice
betray	loyalty_vice
betraying	loyalty_vice
betrayer	loyalty_vice
betrayers	loyalty_vice
unpatriotic	loyalty_vice
betrayed	loyalty_vice
treachery	loyalty_vice
enemies	loyalty_vice
backstabber	loyalty_vice
backstabbed	loyalty_vice
heretic	loyalty_vice
enemy	loyalty_vice
betrays	loyalty_vice
deserter	loyalty_vice
infidels	loyalty_vice
infidel	loyalty_vice
backstab	loyalty_vice
deserting	loyalty_vice
apostate	loyalty_vice
heresy	loyalty_vice
backstabbers	loyalty_vice
heretics	loyalty_vice
unfaithful	loyalty_vice
rebellion	loyalty_vice
desertion	loyalty_vice
deserters	loyalty_vice
apostates	loyalty_vice
unfaithfulness	loyalty_vice
backstabbing	loyalty_vice
rebel	loyalty_vice
cheat on	loyalty_vice
treacherous	loyalty_vice
backstabs	loyalty_vice
heresies	loyalty_vice
outsider	loyalty_vice
outgroup	loyalty_vice
cheated on	loyalty_vice
against us	loyalty_vice
cheating on	loyalty_vice
rebels	loyalty_vice
infidelity	loyalty_vice
outgroups	loyalty_vice
rebellions	loyalty_vice
outsiders	loyalty_vice
cheats on	loyalty_vice
respect	authority_virtue
obey	authority_virtue
authority	authority_virtue
obeyed	authority_virtue
deference	authority_virtue
reverence	authority_virtue
respecting	authority_virtue
obeying	authority_virtue
tradition	authority_virtue
adhere	authority_virtue
obeys	authority_virtue
revere	authority_virtue
govern	authority_virtue
comply	authority_virtue
respectful	authority_virtue
honor	authority_virtue
adhered	authority_virtue
allegiance	authority_virtue
dictates	authority_virtue
nobility	authority_virtue
forbid	authority_virtue
dominion	authority_virtue
governed	authority_virtue
obedient	authority_virtue
reveres	authority_virtue
adhering	authority_virtue
governs	authority_virtue
governing	authority_virtue
oppress	authority_virtue
respected	authority_virtue
respectfully	authority_virtue
honorable	authority_virtue
dictate	authority_virtue
commandments	authority_virtue
commandment	authority_virtue
venerate	authority_virtue
politeness	authority_virtue
respects	authority_virtue
obedience	authority_virtue
divine right	authority_virtue
forbids	authority_virtue
permission	authority_virtue
veneration	authority_virtue
hierarchy	authority_virtue
forbade	authority_virtue
honoring	authority_virtue
proper	authority_virtue
venerated	authority_virtue
stature	authority_virtue
acquiesce	authority_virtue
adherence	authority_virtue
deferential	authority_virtue
leadership	authority_virtue
punish	authority_virtue
forbidding	authority_virtue
revered	authority_virtue
filial piety	authority_virtue
patriarchs	authority_virtue
decree	authority_virtue
coerce	authority_virtue
dominions	authority_virtue
dictating	authority_virtue
venerating	authority_virtue
wear the crown	authority_virtue
venerates	authority_virtue
institution	authority_virtue
monarchical	authority_virtue
servant	authority_virtue
decrees	authority_virtue
permit	authority_virtue
do as one says	authority_virtue
supervise	authority_virtue
duty	authority_virtue
compliance	authority_virtue
lionize	authority_virtue
supervision	authority_virtue
take orders	authority_virtue
take up arms	authority_virtue
duties	authority_virtue
dictated	authority_virtue
elders	authority_virtue
emperors	authority_virtue
commands	authority_virtue
acquiesced	authority_virtue
emperor	authority_virtue
adheres	authority_virtue
servants	authority_virtue
regulations	authority_virtue
covenant	authority_virtue
hierarchical	authority_virtue
subordinate	authority_virtue
policing	authority_virtue
decreeing	authority_virtue
acquiesces	authority_virtue
authorizing	authority_virtue
nobles	authority_virtue
permits	authority_virtue
matriarchal	authority_virtue
authorizes	authority_virtue
control	authority_virtue
command	authority_virtue
subordinating	authority_virtue
hierarchies	authority_virtue
reverential	authority_virtue
deferentially	authority_virtue
punishes	authority_virtue
patriarch	authority_virtue
empires	authority_virtue
honored	authority_virtue
allegiant	authority_virtue
protect	authority_virtue
traditional	authority_virtue
subordination	authority_virtue
punished	authority_virtue
noble	authority_virtue
order	authority_virtue
worship	authority_virtue
social order	authority_virtue
monarchs	authority_virtue
ruling	authority_virtue
lead by example	authority_virtue
authorities	authority_virtue
guiding	authority_virtue
presidents	authority_virtue
slavishly	authority_virtue
patriarchy	authority_virtue
subordinates	authority_virtue
protection	authority_virtue
supervisers	authority_virtue
bow before	authority_virtue
fathers	authority_virtue
bow down	authority_virtue
institutions	authority_virtue
coercion	authority_virtue
governors	authority_virtue
commanded	authority_virtue
police	authority_virtue
authorize	authority_virtue
bullys	authority_virtue
bully	authority_virtue
protecting	authority_virtue
acquiescing	authority_virtue
empire	authority_virtue
mentor	authority_virtue
chiefs	authority_virtue
monarchies	authority_virtue
honors	authority_virtue
preside over	authority_virtue
acquiescent	authority_virtue
allegiances	authority_virtue
bowing	authority_virtue
oligarchy	authority_virtue
willing	authority_virtue
polite	authority_virtue
supervising	authority_virtue
pecking order	authority_virtue
compliantly	authority_virtue
bishops	authority_virtue
monarch	authority_virtue
slaves	authority_virtue
traitors	authority_virtue
punishments	authority_virtue
authorized	authority_virtue
protector	authority_virtue
compliant	authority_virtue
dutiful	authority_virtue
father	authority_virtue
punishment	authority_virtue
coerces	authority_virtue
toe the line	authority_virtue
monarchy	authority_virtue
obediently	authority_virtue
elder	authority_virtue
oligarchies	authority_virtue
dictators	authority_virtue
leaders	authority_virtue
bishop	authority_virtue
lorded over	authority_virtue
worships	authority_virtue
coercing	authority_virtue
protectors	authority_virtue
dictator	authority_virtue
protected	authority_virtue
punishing	authority_virtue
traitor	authority_virtue
commanding	authority_virtue
coerced	authority_virtue
commanders	authority_virtue
pope	authority_virtue
punitive	authority_virtue
underlings	authority_virtue
master	authority_virtue
subordinated	authority_virtue
president	authority_virtue
in charge	authority_virtue
matriarchy	authority_virtue
lionizing	authority_virtue
slave	authority_virtue
chief	authority_virtue
covenants	authority_virtue
commander	authority_virtue
matriarch	authority_virtue
authorizer	authority_virtue
guide	authority_virtue
ordered	authority_virtue
supervised	authority_virtue
captains	authority_virtue
punisher	authority_virtue
supervises	authority_virtue
bossing	authority_virtue
commandant	authority_virtue
governor	authority_virtue
protects	authority_virtue
admiral	authority_virtue
top gun	authority_virtue
bowed	authority_virtue
dominate	authority_virtue
arrest	authority_virtue
mentored	authority_virtue
ordering	authority_virtue
submit	authority_virtue
institutional	authority_virtue
prime minister	authority_virtue
lionizes	authority_virtue
ranking	authority_virtue
boss	authority_virtue
captain	authority_virtue
by the book	authority_virtue
mentors	authority_virtue
bullies	authority_virtue
dominant	authority_virtue
arrested	authority_virtue
bossed	authority_virtue
leader	authority_virtue
rank	authority_virtue
arresting	authority_virtue
chieftain	authority_virtue
prime ministers	authority_virtue
regulation	authority_virtue
superviser	authority_virtue
dean	authority_virtue
arrests	authority_virtue
punishers	authority_virtue
bullied	authority_virtue
matriarchs	authority_virtue
controlling	authority_virtue
managerial	authority_virtue
bosses	authority_virtue
ranks	authority_virtue
controls	authority_virtue
dictation	authority_virtue
guides	authority_virtue
oligarchs	authority_virtue
principals	authority_virtue
top dog	authority_virtue
admirals	authority_virtue
caste	authority_virtue
captaining	authority_virtue
queen	authority_virtue
mentoring	authority_virtue
elderly	authority_virtue
castes	authority_virtue
governess	authority_virtue
captained	authority_virtue
principal	authority_virtue
bullying	authority_virtue
submission	authority_virtue
dominated	authority_virtue
corporate ladders	authority_virtue
queens	authority_virtue
underling	authority_virtue
corporate ladder	authority_virtue
fathered	authority_virtue
dominates	authority_virtue
dominating	authority_virtue
presidential	authority_virtue
oligarch	authority_virtue
controlled	authority_virtue
submits	authority_virtue
submitting	authority_virtue
head honcho	authority_virtue
commandingly	authority_virtue
vice president	authority_virtue
slaving	authority_virtue
fathering	authority_virtue
slaved	authority_virtue
managers	authority_virtue
forbiddingly	authority_virtue
controllers	authority_virtue
submitted	authority_virtue
ringleaders	authority_virtue
ringleader	authority_virtue
controller	authority_virtue
ranked	authority_virtue
manager	authority_virtue
prime ministerial	authority_virtue
submissions	authority_virtue
ceo	authority_virtue
punishingly	authority_virtue
submitter	authority_virtue
submitters	authority_virtue
disrespect	authority_vice
disobey	authority_vice
disobedience	authority_vice
anarchy	authority_vice
chaos	authority_vice
subversion	authority_vice
subvert	authority_vice
lawlessness	authority_vice
subverting	authority_vice
disrespecting	authority_vice
sedition	authority_vice
treason	authority_vice
overthrow	authority_vice
insurrection	authority_vice
rebellion	authority_vice
transgress	authority_vice
treachery	authority_vice
dissent	authority_vice
dishonor	authority_vice
dissension	authority_vice
disrespects	authority_vice
bedlam	authority_vice
rebelling	authority_vice
misrule	authority_vice
transgression	authority_vice
insurrectional	authority_vice
pandemonium	authority_vice
mutiny	authority_vice
mutinies	authority_vice
misruling	authority_vice
disobedient	authority_vice
subverted	authority_vice
transgresses	authority_vice
transgressed	authority_vice
disarray	authority_vice
misruled	authority_vice
rioting	authority_vice
lawless	authority_vice
transgressing	authority_vice
illegality	authority_vice
overthrowing	authority_vice
dishonorable	authority_vice
dishonoring	authority_vice
rebelled	authority_vice
rebellions	authority_vice
riot	authority_vice
dishonouring	authority_vice
disrespected	authority_vice
permissiveness	authority_vice
refuser	authority_vice
unruly	authority_vice
subverts	authority_vice
unlawfulness	authority_vice
overthrown	authority_vice
anarchistic	authority_vice
dishonours	authority_vice
riots	authority_vice
refuse	authority_vice
chaotic	authority_vice
nonconformity	authority_vice
dissenters	authority_vice
uprising	authority_vice
insurrections	authority_vice
rioters	authority_vice
disordering	authority_vice
insubordinate	authority_vice
mutinied	authority_vice
insurrectionist	authority_vice
unlawful	authority_vice
nonconformists	authority_vice
heresy	authority_vice
uprisings	authority_vice
dishonors	authority_vice
tumult	authority_vice
overthrew	authority_vice
overthrows	authority_vice
rabble rousers	authority_vice
renegade	authority_vice
impolite	authority_vice
renegades	authority_vice
rabble rousing	authority_vice
dishonored	authority_vice
illegal	authority_vice
rioter	authority_vice
mutinous	authority_vice
disarrayed	authority_vice
apostates	authority_vice
dissidents	authority_vice
anarchists	authority_vice
raise hell	authority_vice
disorder	authority_vice
refusers	authority_vice
permissive	authority_vice
apostate	authority_vice
anarchist	authority_vice
treacherous	authority_vice
dissident	authority_vice
raises hell	authority_vice
disordered	authority_vice
heretic	authority_vice
overpower	authority_vice
rabble rouser	authority_vice
rebel	authority_vice
raising hell	authority_vice
heretics	authority_vice
unauthorized	authority_vice
refusing	authority_vice
rebels	authority_vice
refuses	authority_vice
rioted	authority_vice
orders	authority_vice
dissenter	authority_vice
chaotically	authority_vice
nonconformist	authority_vice
heresies	authority_vice
illegals	authority_vice
unlawfully	authority_vice
heretical	authority_vice
dissents	authority_vice
traditions	authority_vice
dissenting	authority_vice
overpowers	authority_vice
trouble maker	authority_vice
refused	authority_vice
rock the boat	authority_vice
overpowering	authority_vice
tumultuous	authority_vice
overpowered	authority_vice
dissented	authority_vice
nonconforming	authority_vice
sanctity	sanctity_virtue
sacred	sanctity_virtue
sacredness	sanctity_virtue
purity	sanctity_virtue
wholesome	sanctity_virtue
pureness	sanctity_virtue
wholesomeness	sanctity_virtue
holiness	sanctity_virtue
dignity	sanctity_virtue
godly	sanctity_virtue
piety	sanctity_virtue
sanctify	sanctity_virtue
chastity	sanctity_virtue
undefiled	sanctity_virtue
holy	sanctity_virtue
sacrosanct	sanctity_virtue
pious	sanctity_virtue
righteousness	sanctity_virtue
dignities	sanctity_virtue
sanctified	sanctity_virtue
godliness	sanctity_virtue
spirituality	sanctity_virtue
chaste	sanctity_virtue
sanctifies	sanctity_virtue
righteous	sanctity_virtue
divine	sanctity_virtue
religious	sanctity_virtue
biblical	sanctity_virtue
spiritual	sanctity_virtue
deity	sanctity_virtue
sanctifying	sanctity_virtue
noble	sanctity_virtue
modesty	sanctity_virtue
decency	sanctity_virtue
scriptures	sanctity_virtue
nobility	sanctity_virtue
religion	sanctity_virtue
hallow	sanctity_virtue
soul	sanctity_virtue
hallowed	sanctity_virtue
deism	sanctity_virtue
pristine	sanctity_virtue
exalted	sanctity_virtue
hallowing	sanctity_virtue
eternal	sanctity_virtue
holy cross	sanctity_virtue
deities	sanctity_virtue
faith	sanctity_virtue
unadulterated	sanctity_virtue
scripture	sanctity_virtue
wholesomely	sanctity_virtue
divinities	sanctity_virtue
worship	sanctity_virtue
virgin	sanctity_virtue
god	sanctity_virtue
catholicism	sanctity_virtue
saintly	sanctity_virtue
saintliness	sanctity_virtue
goddess	sanctity_virtue
religiosity	sanctity_virtue
purify	sanctity_virtue
koranic	sanctity_virtue
pure	sanctity_virtue
holy crosses	sanctity_virtue
exalt	sanctity_virtue
virginity	sanctity_virtue
divinity	sanctity_virtue
consecrates	sanctity_virtue
heaven	sanctity_virtue
virginal	sanctity_virtue
devout	sanctity_virtue
dignified	sanctity_virtue
tabernacle	sanctity_virtue
exalts	sanctity_virtue
buddhas	sanctity_virtue
souls	sanctity_virtue
temple	sanctity_virtue
unsullied	sanctity_virtue
heavenly	sanctity_virtue
cleanliness	sanctity_virtue
abstinance	sanctity_virtue
spotlessness	sanctity_virtue
talmudic	sanctity_virtue
deists	sanctity_virtue
gospels	sanctity_virtue
prophets	sanctity_virtue
religions	sanctity_virtue
temples	sanctity_virtue
buddhist	sanctity_virtue
goddesses	sanctity_virtue
saints	sanctity_virtue
temperance	sanctity_virtue
celibacy	sanctity_virtue
consecrated	sanctity_virtue
priestly	sanctity_virtue
bless	sanctity_virtue
marriage	sanctity_virtue
prophet	sanctity_virtue
exalting	sanctity_virtue
unchaste	sanctity_virtue
supernatural	sanctity_virtue
eternally	sanctity_virtue
purification	sanctity_virtue
apostles	sanctity_virtue
monastic	sanctity_virtue
purified	sanctity_virtue
communion	sanctity_virtue
gods	sanctity_virtue
celibate	sanctity_virtue
christians	sanctity_virtue
theological	sanctity_virtue
monasticism	sanctity_virtue
unspoiled	sanctity_virtue
sterility	sanctity_virtue
christian	sanctity_virtue
buddha	sanctity_virtue
deist	sanctity_virtue
prophetic	sanctity_virtue
saint	sanctity_virtue
righteously	sanctity_virtue
apostle	sanctity_virtue
prayer	sanctity_virtue
faiths	sanctity_virtue
shrine	sanctity_virtue
purifying	sanctity_virtue
worships	sanctity_virtue
virgins	sanctity_virtue
glorious	sanctity_virtue
dignifies	sanctity_virtue
atonement	sanctity_virtue
deification	sanctity_virtue
orthodoxy	sanctity_virtue
hallows	sanctity_virtue
enshrining	sanctity_virtue
nunneries	sanctity_virtue
church	sanctity_virtue
religiously	sanctity_virtue
blessings	sanctity_virtue
consecrate	sanctity_virtue
gospel	sanctity_virtue
pray	sanctity_virtue
beatifying	sanctity_virtue
yogis	sanctity_virtue
theology	sanctity_virtue
purifies	sanctity_virtue
orthodox	sanctity_virtue
untainted	sanctity_virtue
torah	sanctity_virtue
faithfully	sanctity_virtue
catholic	sanctity_virtue
heavens	sanctity_virtue
yogi	sanctity_virtue
consecrating	sanctity_virtue
blessed	sanctity_virtue
faithful	sanctity_virtue
koran	sanctity_virtue
abstinence	sanctity_virtue
jesus	sanctity_virtue
monastery	sanctity_virtue
purities	sanctity_virtue
consecration	sanctity_virtue
catholics	sanctity_virtue
prayers	sanctity_virtue
prayed	sanctity_virtue
sterile	sanctity_virtue
blesses	sanctity_virtue
enshrined	sanctity_virtue
torahs	sanctity_virtue
organic	sanctity_virtue
bible	sanctity_virtue
glory	sanctity_virtue
allah	sanctity_virtue
glories	sanctity_virtue
priests	sanctity_virtue
dignifying	sanctity_virtue
enshrine	sanctity_virtue
mosques	sanctity_virtue
spotlessly	sanctity_virtue
prude	sanctity_virtue
reverend	sanctity_virtue
soulful	sanctity_virtue
deify	sanctity_virtue
christ	sanctity_virtue
cathedrals	sanctity_virtue
churches	sanctity_virtue
cathedral	sanctity_virtue
dignify	sanctity_virtue
monasteries	sanctity_virtue
raw	sanctity_virtue
enshrines	sanctity_virtue
refinement	sanctity_virtue
nuns	sanctity_virtue
monks	sanctity_virtue
gloriously	sanctity_virtue
almighty	sanctity_virtue
marring	sanctity_virtue
repent	sanctity_virtue
prays	sanctity_virtue
clean	sanctity_virtue
orthodoxies	sanctity_virtue
exterminates	sanctity_virtue
rabbis	sanctity_virtue
spotless	sanctity_virtue
bibles	sanctity_virtue
mosque	sanctity_virtue
immaculate	sanctity_virtue
organics	sanctity_virtue
purifier	sanctity_virtue
foods	sanctity_virtue
lord	sanctity_virtue
praying	sanctity_virtue
repenting	sanctity_virtue
marry	sanctity_virtue
elevating	sanctity_virtue
marrying	sanctity_virtue
immaculately	sanctity_virtue
rabbi	sanctity_virtue
nunnery	sanctity_virtue
priest	sanctity_virtue
food	sanctity_virtue
bloodiness	sanctity_virtue
marries	sanctity_virtue
synagogues	sanctity_virtue
synagogue	sanctity_virtue
refined	sanctity_virtue
repents	sanctity_virtue
angel	sanctity_virtue
blessing	sanctity_virtue
monk	sanctity_virtue
rabbinical	sanctity_virtue
organically	sanctity_virtue
pope	sanctity_virtue
nun	sanctity_virtue
nobles	sanctity_virtue
prophetically	sanctity_virtue
blood	sanctity_virtue
repented	sanctity_virtue
pastor	sanctity_virtue
purifiers	sanctity_virtue
lords	sanctity_virtue
bloody	sanctity_virtue
untouched	sanctity_virtue
cleaning	sanctity_virtue
exterminating	sanctity_virtue
exterminated	sanctity_virtue
imam	sanctity_virtue
higher power	sanctity_virtue
cleaners	sanctity_virtue
married	sanctity_virtue
beatification	sanctity_virtue
beatify	sanctity_virtue
extermination	sanctity_virtue
exterminate	sanctity_virtue
cleaner	sanctity_virtue
body	sanctity_virtue
immune	sanctity_virtue
atoning	sanctity_virtue
imams	sanctity_virtue
cleaned	sanctity_virtue
atones	sanctity_virtue
mary	sanctity_virtue
refines	sanctity_virtue
cleans	sanctity_virtue
atone	sanctity_virtue
immunities	sanctity_virtue
immunity	sanctity_virtue
stainless	sanctity_virtue
refining	sanctity_virtue
refine	sanctity_virtue
atoned	sanctity_virtue
exterminator	sanctity_virtue
exterminators	sanctity_virtue
impurity	sanctity_vice
degradation	sanctity_vice
depravity	sanctity_vice
desecrate	sanctity_vice
desecration	sanctity_vice
repulsiveness	sanctity_vice
degrading	sanctity_vice
decay	sanctity_vice
filth	sanctity_vice
depravities	sanctity_vice
defile	sanctity_vice
sin	sanctity_vice
fornication	sanctity_vice
repulsive	sanctity_vice
depraved	sanctity_vice
impiety	sanctity_vice
degrade	sanctity_vice
repugnance	sanctity_vice
impure	sanctity_vice
degraded	sanctity_vice
desecrations	sanctity_vice
sinfulness	sanctity_vice
impurities	sanctity_vice
indecencies	sanctity_vice
defiled	sanctity_vice
defiles	sanctity_vice
uncleanliness	sanctity_vice
damnation	sanctity_vice
debauchery	sanctity_vice
impious	sanctity_vice
sinful	sanctity_vice
necrophiliacs	sanctity_vice
desecrates	sanctity_vice
sleaziness	sanctity_vice
desecrating	sanctity_vice
desecrated	sanctity_vice
grossness	sanctity_vice
contaminates	sanctity_vice
sinning	sanctity_vice
promiscuity	sanctity_vice
befouls	sanctity_vice
rottenness	sanctity_vice
hedonism	sanctity_vice
revolting	sanctity_vice
repugnant	sanctity_vice
godless	sanctity_vice
scum	sanctity_vice
befoul	sanctity_vice
satanic	sanctity_vice
sluttiness	sanctity_vice
disgusting	sanctity_vice
pestilence	sanctity_vice
debased	sanctity_vice
trashiness	sanctity_vice
sins	sanctity_vice
degradingly	sanctity_vice
corrupting	sanctity_vice
deprave	sanctity_vice
perverted	sanctity_vice
debase	sanctity_vice
fornicating	sanctity_vice
degraders	sanctity_vice
defiling	sanctity_vice
slime	sanctity_vice
horrors	sanctity_vice
repugnantly	sanctity_vice
defiler	sanctity_vice
deviants	sanctity_vice
degrades	sanctity_vice
corrupts	sanctity_vice
debasing	sanctity_vice
perverts	sanctity_vice
parasitic	sanctity_vice
disgusts	sanctity_vice
deflowering	sanctity_vice
hedonistic	sanctity_vice
deviant	sanctity_vice
scummy	sanctity_vice
horrifying	sanctity_vice
necrophilia	sanctity_vice
contamination	sanctity_vice
rot	sanctity_vice
stain	sanctity_vice
contaminating	sanctity_vice
contaminants	sanctity_vice
dirtying	sanctity_vice
debases	sanctity_vice
contaminate	sanctity_vice
abhor	sanctity_vice
heresy	sanctity_vice
sleaze	sanctity_vice
staining	sanctity_vice
defilers	sanctity_vice
harlot	sanctity_vice
plagues	sanctity_vice
sullies	sanctity_vice
fornicators	sanctity_vice
vermin	sanctity_vice
befouling	sanctity_vice
incest	sanctity_vice
trashy	sanctity_vice
excreting	sanctity_vice
deforms	sanctity_vice
abhorred	sanctity_vice
decayed	sanctity_vice
whores	sanctity_vice
deformities	sanctity_vice
perverse	sanctity_vice
adultery	sanctity_vice
fornicate	sanctity_vice
excrement	sanctity_vice
harlots	sanctity_vice
decaying	sanctity_vice
fornicator	sanctity_vice
unclean	sanctity_vice
nauseating	sanctity_vice
sully	sanctity_vice
heresies	sanctity_vice
satan	sanctity_vice
damns	sanctity_vice
satanically	sanctity_vice
sinned	sanctity_vice
sinners	sanctity_vice
adulterous	sanctity_vice
repulses	sanctity_vice
corruption	sanctity_vice
tainting	sanctity_vice
deformity	sanctity_vice
necrophiliac	sanctity_vice
decays	sanctity_vice
corrupted	sanctity_vice
deforming	sanctity_vice
contaminant	sanctity_vice
disgust	sanctity_vice
tarnishes	sanctity_vice
hell	sanctity_vice
filthy	sanctity_vice
taint	sanctity_vice
horrific	sanctity_vice
fecal	sanctity_vice
dirtied	sanctity_vice
flesh	sanctity_vice
stained	sanctity_vice
deform	sanctity_vice
putrid	sanctity_vice
scatalogical	sanctity_vice
dirties	sanctity_vice
whoring	sanctity_vice
cocksucker	sanctity_vice
plague	sanctity_vice
adulterers	sanctity_vice
excretes	sanctity_vice
infesting	sanctity_vice
slimy	sanctity_vice
excrete	sanctity_vice
scuzz	sanctity_vice
horror	sanctity_vice
tarnish	sanctity_vice
sexuality	sanctity_vice
parasite	sanctity_vice
obscenity	sanctity_vice
deformed	sanctity_vice
adulterer	sanctity_vice
befouled	sanctity_vice
muck	sanctity_vice
corpses	sanctity_vice
soiled	sanctity_vice
infest	sanctity_vice
incestuously	sanctity_vice
incestuous	sanctity_vice
fucker	sanctity_vice
devil	sanctity_vice
parasites	sanctity_vice
stains	sanctity_vice
skanks	sanctity_vice
corpse	sanctity_vice
whore	sanctity_vice
lepers	sanctity_vice
curses	sanctity_vice
corrupt	sanctity_vice
pathogens	sanctity_vice
diseased	sanctity_vice
deflower	sanctity_vice
hedonists	sanctity_vice
sinner	sanctity_vice
debaucherous	sanctity_vice
fester	sanctity_vice
hedonist	sanctity_vice
sleazy	sanctity_vice
fucks	sanctity_vice
promiscuous	sanctity_vice
cursed	sanctity_vice
curse	sanctity_vice
apostates	sanctity_vice
cocksuckers	sanctity_vice
heretic	sanctity_vice
lewdness	sanctity_vice
slutty	sanctity_vice
infests	sanctity_vice
festers	sanctity_vice
pervert	sanctity_vice
fuck	sanctity_vice
skanky	sanctity_vice
dirty	sanctity_vice
mucky	sanctity_vice
puke	sanctity_vice
alcoholism	sanctity_vice
feces	sanctity_vice
sullied	sanctity_vice
disgustingly	sanctity_vice
sexual	sanctity_vice
cunt	sanctity_vice
taints	sanctity_vice
profane	sanctity_vice
heretics	sanctity_vice
fucking	sanctity_vice
tarnishing	sanctity_vice
fornicated	sanctity_vice
mar	sanctity_vice
shitting	sanctity_vice
slut	sanctity_vice
obscene	sanctity_vice
barf	sanctity_vice
rotten	sanctity_vice
disgusted	sanctity_vice
cunts	sanctity_vice
waste	sanctity_vice
parasitically	sanctity_vice
sinfully	sanctity_vice
wastes	sanctity_vice
vomit	sanctity_vice
pathogen	sanctity_vice
rats	sanctity_vice
pathogenic	sanctity_vice
indecent	sanctity_vice
infect	sanctity_vice
leper	sanctity_vice
indecently	sanctity_vice
shit	sanctity_vice
abhors	sanctity_vice
skank	sanctity_vice
infestation	sanctity_vice
deflowered	sanctity_vice
leprosy	sanctity_vice
diseases	sanctity_vice
heretical	sanctity_vice
dirt	sanctity_vice
cursing	sanctity_vice
tarnishment	sanctity_vice
disease	sanctity_vice
prostitution	sanctity_vice
infested	sanctity_vice
apostate	sanctity_vice
sluts	sanctity_vice
fuckers	sanctity_vice
profanity	sanctity_vice
addiction	sanctity_vice
contaminated	sanctity_vice
scuzzy	sanctity_vice
infectiousness	sanctity_vice
indecency	sanctity_vice
vomited	sanctity_vice
germ	sanctity_vice
prostituting	sanctity_vice
excreted	sanctity_vice
rubbish	sanctity_vice
fucked	sanctity_vice
sodomy	sanctity_vice
untouchables	sanctity_vice
epidemics	sanctity_vice
swear	sanctity_vice
shits	sanctity_vice
whorehouses	sanctity_vice
pigsty	sanctity_vice
germs	sanctity_vice
prostituted	sanctity_vice
mud	sanctity_vice
dung	sanctity_vice
epidemic	sanctity_vice
rat	sanctity_vice
douchebag	sanctity_vice
perversely	sanctity_vice
pukes	sanctity_vice
puking	sanctity_vice
prostitutes	sanctity_vice
barfs	sanctity_vice
slutting	sanctity_vice
trashing	sanctity_vice
whored	sanctity_vice
douchebags	sanctity_vice
infection	sanctity_vice
shite	sanctity_vice
spoil	sanctity_vice
gross	sanctity_vice
repulsed	sanctity_vice
pus	sanctity_vice
festering	sanctity_vice
cockroaches	sanctity_vice
tainted	sanctity_vice
contagion	sanctity_vice
barfed	sanctity_vice
infects	sanctity_vice
damned	sanctity_vice
addictions	sanctity_vice
shitty	sanctity_vice
skanking	sanctity_vice
trash	sanctity_vice
whorehouse	sanctity_vice
phlegm	sanctity_vice
moldy	sanctity_vice
plaguing	sanctity_vice
shat	sanctity_vice
drugged	sanctity_vice
garbage	sanctity_vice
infecting	sanctity_vice
pandemics	sanctity_vice
viruses	sanctity_vice
nauseated	sanctity_vice
cockroach	sanctity_vice
puked	sanctity_vice
drugging	sanctity_vice
manure	sanctity_vice
mucking	sanctity_vice
lewd	sanctity_vice
alcoholics	sanctity_vice
gangrenous	sanctity_vice
barfing	sanctity_vice
gangrene	sanctity_vice
shitter	sanctity_vice
shittier	sanctity_vice
tarnished	sanctity_vice
cock	sanctity_vice
vomits	sanctity_vice
hookers	sanctity_vice
damn	sanctity_vice
addict	sanctity_vice
alcoholic	sanctity_vice
nausea	sanctity_vice
swearing	sanctity_vice
vomiting	sanctity_vice
skanked	sanctity_vice
infections	sanctity_vice
foul	sanctity_vice
prostitute	sanctity_vice
risque	sanctity_vice
lice	sanctity_vice
gonorrhea	sanctity_vice
wasting	sanctity_vice
profanities	sanctity_vice
divorces	sanctity_vice
crappy	sanctity_vice
spreading	sanctity_vice
wasters	sanctity_vice
addicting	sanctity_vice
trashed	sanctity_vice
addicts	sanctity_vice
scabies	sanctity_vice
swore	sanctity_vice
nauseous	sanctity_vice
phlegmatically	sanctity_vice
spoiling	sanctity_vice
nauseatingly	sanctity_vice
drugs	sanctity_vice
virus	sanctity_vice
waster	sanctity_vice
untouchable	sanctity_vice
addicted	sanctity_vice
damning	sanctity_vice
pandemic	sanctity_vice
hooker	sanctity_vice
bm	sanctity_vice
infected	sanctity_vice
festered	sanctity_vice
marred	sanctity_vice
phlegmatic	sanctity_vice
divorce	sanctity_vice
viral	sanctity_vice
contagiously	sanctity_vice
plagued	sanctity_vice
repulsing	sanctity_vice
swears	sanctity_vice
drug	sanctity_vice
spoiled	sanctity_vice
cum	sanctity_vice
divorcing	sanctity_vice
wasted	sanctity_vice
divorced	sanctity_vice
contagious	sanctity_vice
